R 800 800
F 220,100,0
C 225,30,0
NO ./texture/GrayWalls.xpm
SO ./texture/bluestone.xpm
S  ./texture/barrel.xpm
WE ./texture/CRTXPM.xpm
EA ./texture/brick.xpm

111111111111111111111111111111111
1       1000000000110000000000001
1       1011000001110002222200001
1       1001000000000002222200001
111111111011000001110000000000001
100000000011000001110111110111111
11110111111111011100000010001
11110111111111011101010010001
11000000110101011100000010001
10002000000000001100000010001
1000000000000000110101001N001
1100000111010101111101111000111
11110111 1110101 101111010001
11111111 1111111 111111111111